NO map/texture/wall_texture.xpm
SO map/texture/wall_texture.xpm
EA map/texture/wall_texture.xpm
WE map/texture/wall_texture.xpm
F 220,100,20
C 225,253,0
1111111111111111111111111111111111111111111
1000000000000000000000000000000000000000001
1000000000000000000000000000000000000000001
1000000000000000000000000000000000000000001
1000000000000000000000000000000000000000001
1000000000000000000000000000000000000000001
1000000000000000000000000000000000000000001
1000000000000000000000000000000000000000001
1000000000000000000000000000000000000000001
1000000000000000000000000000000000000000001
1000000000000000000000000000000000000000001
1000000000000000000000000000000000000000001
1000000000000000000000000000000000000000001
1000000000000000000000000000000000000000001
1000000000000000000000000000000000000000001
1000000000000000000000000000000000000000001
100000000000000N000000000000000000000000001
1111111111111111111111111111111111111111111
