NO asset/texture/TILE_1A.xpm
SO asset/texture/TILE_1E.xpm
EA asset/texture/TILE_2A.xpm
WE asset/texture/TILE_2E.xpm
F asset/texture/FLOOR_2E.xpm
C asset/texture/PIPES_1A.xpm
D asset/texture/DOOR_1B.xpm

        1111111111111111111111111
        1E0000000M1100A0000000001
        1011000001110R01000010001
        10R100A00N0O0000P000000W1
111111111011000001110000M00000001
1A000000001100000111C111111111111
11110111111111011100000010R01
11110111111111011101010010001
11000000110101011100A00010001
1A0000000000A0000C00000000001
1000P000000000001101M10010001
11000001110101011111011110P0111
1111M111 1110101 101111010001
11111111 1111111 111111111111
