NO asset/texture/TILE_1A.xpm
SO asset/texture/TILE_1E.xpm
EA asset/texture/TILE_2A.xpm
WE asset/texture/TILE_2E.xpm
F asset/texture/FLOOR_2E.xpm
C asset/texture/PIPES_1A.xpm
D asset/texture/DOOR_1B.xpm

1111111111111111111111111111111111111111111111111111111111111111
1000000000000000000000000000000000000000000000000000000000000001
1000000000000000000000000000000000000000000000000000000000000001
1000000000000000000000000000000000000000000000000000000000000001
1000000000000000000000000000000000000000000000000000000000000001
1000000000000000000000000000000000000000000000000000000000000001
1000000000000000000000000000000000000000000000000000000000000001
10000000000011111111111111111111C1111111111111111111100000000001
1000000000001000000000000000000000000000000000000000100000000001
1000000000001000000000000000000000000000000000000000100000000001
1000000000001000000000000000000000000000000000000000100000000001
1000000000001000000000000000000000000000000000000000100000000001
1000000000001000000000000000000000000000000000000000100000000001
1000000000001000000000000000000000000000000000000000100000000001
1000000000001000000000000000000000000000000000000000100000000001
1000000000001000000000000000000000000000000000000000100000000001
1000000000001000000000000000000000000000000000000000100000000001
1000000000001000000000000000000000000000000000000000100000000001
100000000000C000000000000000000000000000000000000000C00000000001
1000000000001000000000000000000000000000000000000000100000000001
1000000000001000000000000000000000000000000000000000100000000001
1000000000001000000000000000000000000000000000000000100000000001
1000000000001000000000000000000000000000000000000000100000000001
1000000000001000000000000000000000000000000000000000100000000001
1000000000001000000000000000000000000000000000000000100000000001
1000000000001000000000000000000000000000000000000000100000000001
1000000000001000000000000000000000000000000000000000100000000001
1000000000001000000000000000000000000000000000000000100000000001
1000000000001000000000000000000000000000000000000000100000000001
10000000000011111111111111111111C1111111111111111111100000000001
1000000000000000000000000000000000000000000000000000000000000001
1000000000000000000000000000000000000000000000000000000000000001
1000000000000000000000000000000000000000000000000000000000000001
1000000000000000000000000000000000000000000000000000000000000001
1000000000000000000000000000000000000000000000000000000000000001
1000000000000000000000000000000000000000000000000000000000000001
1111111111111111111111111111111111111111111111111111111111111111
