NO asset/texture/TILE_1A.xpm
SO asset/texture/TILE_1E.xpm
EA asset/texture/TILE_2A.xpm
WE asset/texture/TILE_2E.xpm
F asset/texture/FLOOR_2E.xpm
C asset/texture/PIPES_2A.xpm
D asset/texture/DOOR_1B.xpm

        1111111111111111111111111
        1E000000001100AAAA0000001
        1011000001110001000010001
        100100000N0O00000000000W1
111111111011000001110000000000001
10000000001100000111C111111111111
11110111111111011100000010001
11110111111111011101010010001
11000000110101011100000010001
10000000000000000C00000000001
10000000000000001101010010001
1100000111010101111101111000111
11110111 1110101 101111010001
11111111 1111111 111111111111
