NO map/texture/wall_texture.xpm
SO map/texture/wall_texture.xpm
EA map/texture/wall_texture.xpm
WE map/texture/wall_texture.xpm
F 220,100,20
C 225,253,0
111111111111111111111111111
100000000000000000000000001
100000000000000000000000001
100000000000000000000000001
100000000000000N00000000001
111111111111111111111111111
