NO map/texture/wall_texture.xpm
SO map/texture/wall_texture.xpm
EA map/texture/wall_texture.xpm
WE map/texture/wall_texture.xpm
F 220,100,20
C 225,253,0
1111111111111111111111111111111111111111111
1010010100100100100100100100100100100100101
1001010001001000100010010010011010010010001
1010000100010010001000100001000010001000011
1010010100100100100100100100100100100100101
1010010100100100100100100100100100100100101
1010010100100100100100100100100100100100101
1001010001001000100010010010011010010010001
1010000100010010001000000001000010001000011
1001010001001000100010010010011010010010001
1010000100010010001000100001000000001000011
1001010001001000100010010010011000010010001
1010000100010010001000100001000000001000011
1010N00100010010001000100001000010001000011
1001010001001000100010010010011010010010001
1111111111111111111111111111111111111111111
